0000000000000000000000000000000000000000
0000000000000000000000000000000000p00p0s
0000000000000000000000000000000000wwwwww
00000000000000000000000000000p000w000000
00000000000000000000000000000000w0000000
00000000000000000000000000000www00000000
000000000000000000000000000ww00000000000
00000000000000000000000000w0000000000000
00000000000000000000000000w0000000000000
00000000000000000000000000w0000000000000
00000000000000000000000000w0000000000000
0000000000000000000000000w0000000s00p00s
000000000000000000000000w00000000wwwwwww
00d00w000000000000p0000v0000000000000000
00000w0000000000000000v00000000000000000
000000wwwwwwwwwwwwwwww0000000d0000000000
0000000000000000000000000000000000000000
0000000000000000000000000000000000000000
0000000000000000000000000000000000000000
s00000000000000000000000000000000000000s
w00000p0000000000p0000000000p00s0000000w
w000000000000000000000000000000w0000000w
wwwwwwwwwwwwwwwwwwwwwwwwwwwwwwww0000000w
00000000000000000000000000000000000d000w
000000000000000000000000000000000000000w
sssss0000000000000000000000000000000000w
wwwww0000000000000000000000000000000000w
w000v000000000000p0000000000p0000000000w
w0h0vb000000000000000000000000000000000w
wwwwwwwwwwwwwwwwwwwwwwwwwwwwwwwwwwwwwwww
