00000000000000d00000
00000000000000000000
00000000000000000000
00000000000000000000
00000000000000000000
0000000wwwwwww000000
000000wwwwwww0000000
w00000wwwwwww00000ww
0wwwww00000000000w00
0000000000000000w000
000000000000000w0000
000w0000000000w00000
w000000000000w000000
ww0000000000w0000000
wwwwwwwwwwwwwwwwwwww
00000000000000d00000
00000000000000000000
00000000000000000000
00000000000000000000
00000000000000000000
0000000wwwwwww000000
000000wwwwwww0000000
w00000wwwwwww00000ww
0wwwww00000000000w00
0000000000000000w000
000000000000000w0000
000w0000000000w00000
w000000000000w000000
ww0000000000w0000000
wwwwwwwwwwwwwwwwwwww