0000000000000000000000000000000000000000
0000000000000000000000000000000000p00p0s
0000000000000000000000000000000000wwwwww
00000000000000000000000000000p000w000000
00000000000000000000000000000000w0000000
00000000000000000000000000000www00000000
000000000000000000000000000ww00000000000
00000000000000000000000000w0000000000000
00000000000000000000000000w0000000000000
00000000000000000000000000w0000000000000
00000000000000000000000000w000000s00p000
000000000000000000p000000w0000000w00000w
000000000000000000000000w00000000wwwwwww
00d00w00000000000000000w0000000000000000
00000w0000000000000000w00000000000000000
000000wwwwwwwwwwwwwwww0000000d0000000000
0000000000000000000000000000000000000000
0000000000000000000000000000000000000000
0000000000000000000000000000000000000000
s00000p0000000000p0000000000p0000000000s
w000000000000000000000000000000s0000000w
w000000000000000000000000000000w0000000w
wwwwwwwwwwwwwwwwwwwwwwwwwwwwwwww0000000w
00000000000000000000000000000000000d000w
000000000000000000000000000000000000000w
000000000000000000000000000000000000000w
00000000000000000p0000000000p0000000000w
ss0000000000000000000000000000000000000w
ww0b00000000000000000000000000000000000w
wwwwwwwwwwwwwwwwwwwwwwwwwwwwwwwwwwwwwwww
