w00000000000000000000000000000000000000w
w0h000000000000000000000000000000000000w
w00000000000000000000000000000000000000w
w00000000000000000000000000000l000v0000w
w00000000d000000000l0000000000000v00000w
w0000000000000000000000000g000vvv000000w
w00000000000000000000000000000v00000000w
w0000000000000000000000000000v000000000w
w000000000000000000000000000v0000000000w
w000000000000000000d00000vvv00000000000w
w00000000000000000000000000000000000000w
w00000000000000000000000000000000000000w
w00000000000000000000000000000000000000w
w000000000000000000d0000000000000000000w
w00l0000000l000000000000000000000000000w
w00000000000000000000000000000000000000w
w00v000g000v000000000000000000000000000w
w000v00000v00000000d0000000000000000000w
w0000v000v00000000000000000000000000000w
w00000vvv000000000000000000000000000000w
w00000000000000000000000000000000000000w
w000000000000000000d0000000000000000000w
w00000000000000000000000000000000000000w
w00000000000000000000000000000000000000w
w000000000000000000000000000000G0000000w
w000000000000000000d0000000000000000000w
w00000000000000000000000000000000000000w
w000000000000000000000000000000000l0000w
w0b000000000000000000000000000000000000w
wwwwwwwwwwwwwwwwssssssswwwwwwwwwwwwwwwww

